100,100,100,100,100,100,100,100,100,100,100,100,100,100,100,100,100,100,100,100,100,100,100,100,100,100,100,100,100,100,100,100,100,100,100,128,128,128,128,128,128,128,128,128,128,100,100,100,100,100,100,100,100,100,100,100,100,100,100,100,100,100,100,100,100,100,100,100,100,100,100,100,100,100,100,100,100,100,100,100
100,100,100,100,100,100,100,100,100,100,100,100,100,100,100,100,100,100,100,100,100,100,100,100,100,100,100,100,100,100,100,128,128,128,128,128,128,128,128,128,128,128,128,128,128,128,128,128,128,100,100,100,100,100,100,100,100,100,100,100,100,100,100,100,100,100,100,100,100,100,100,100,100,100,100,100,100,100,100,100
100,100,100,100,100,100,100,100,100,100,100,100,100,100,100,100,100,100,100,100,100,100,100,100,100,100,100,100,128,128,128,128,128,128,128,255,255,255,255,255,255,255,255,255,255,128,128,128,128,128,128,128,100,100,100,100,100,100,100,100,100,100,100,100,100,100,100,100,100,100,100,100,100,100,100,100,100,100,100,100
100,100,100,100,100,100,100,100,100,100,100,100,100,100,100,100,100,100,100,100,100,100,100,100,100,100,128,128,128,128,128,255,255,255,255,255,255,255,255,255,255,255,255,255,255,255,255,255,255,128,128,128,128,128,100,100,100,100,100,100,100,100,100,100,100,100,100,100,100,100,100,100,100,100,100,100,100,100,100,100
100,100,100,100,100,100,100,100,100,100,100,100,100,100,100,100,100,100,100,100,100,100,100,100,128,128,128,128,255,255,255,255,255,255,255,255,255,255,255,255,255,255,255,255,255,255,255,255,255,255,255,255,128,128,128,128,100,100,100,100,100,100,100,100,100,100,100,100,100,100,100,100,100,100,100,100,100,100,100,100
100,100,100,100,100,100,100,100,100,100,100,100,100,100,100,100,100,100,100,100,100,100,100,128,128,128,255,255,255,255,255,255,255,255,255,255,255,255,255,0,0,255,255,255,255,255,255,255,255,255,255,255,255,255,128,128,128,100,100,100,100,100,100,100,100,100,100,100,100,100,100,100,100,100,100,100,100,100,100,100
100,100,100,100,100,100,100,100,100,100,100,100,100,100,100,100,100,100,100,100,100,128,128,128,255,255,255,255,255,255,255,255,255,255,255,255,255,255,255,0,0,255,255,255,255,255,255,255,255,255,255,255,255,255,255,255,128,128,128,100,100,100,100,100,100,100,100,100,100,100,100,100,100,100,100,100,100,100,100,100
100,100,100,100,100,100,100,100,100,100,100,100,100,100,100,100,100,100,100,100,128,128,128,255,255,255,255,255,255,0,0,255,255,255,255,255,255,255,255,255,255,255,255,255,255,255,255,255,255,0,0,255,255,255,255,255,255,128,128,128,100,100,100,100,100,100,100,100,100,100,100,100,100,100,100,100,100,100,100,100
100,100,100,100,100,100,100,100,100,100,100,100,100,100,100,100,100,100,100,128,128,255,255,255,255,255,255,255,255,0,0,255,255,255,255,255,255,255,255,255,255,255,255,255,255,255,255,255,255,0,0,255,255,255,255,255,255,255,255,128,128,100,100,100,100,100,100,100,100,100,100,100,100,100,100,100,100,100,100,100
100,100,100,100,100,100,100,100,100,100,100,100,100,100,100,100,100,100,128,128,255,255,255,255,255,255,255,255,255,255,255,255,255,0,0,0,0,0,0,255,255,0,0,0,0,0,0,255,255,255,255,255,255,255,255,255,255,255,255,255,128,128,100,100,100,100,100,100,100,100,100,100,100,100,100,100,100,100,100,100
100,100,100,100,100,100,100,100,100,100,100,100,100,100,100,100,100,128,128,255,255,255,255,255,255,255,255,255,255,255,255,0,0,255,255,255,255,255,255,255,255,255,255,255,255,255,255,0,0,255,255,255,255,255,255,255,255,255,255,255,255,128,128,100,100,100,100,100,100,100,100,100,100,100,100,100,100,100,100,100
100,100,100,100,100,100,100,100,100,100,100,100,100,100,100,100,128,128,255,255,255,255,255,255,255,255,255,255,255,0,0,255,255,255,255,255,255,255,255,255,255,255,255,255,255,255,255,255,255,0,0,255,255,255,255,255,255,255,255,255,255,255,128,128,100,100,100,100,100,100,100,100,100,100,100,100,100,100,100,100
100,100,100,100,100,100,100,100,100,100,100,100,100,100,100,100,128,128,255,255,255,0,0,255,255,255,255,255,0,255,255,255,255,255,255,255,255,255,255,255,255,255,255,255,255,255,255,255,255,255,255,0,255,255,255,255,255,0,0,255,255,255,128,128,100,100,100,100,100,100,100,100,100,100,100,100,100,100,100,100
100,100,100,100,100,100,100,100,100,100,100,100,100,100,100,128,128,255,255,255,255,0,0,255,255,255,0,0,255,255,255,255,255,255,0,0,0,0,0,0,0,0,0,0,0,0,255,255,255,255,255,255,0,0,255,255,255,0,0,255,255,255,255,128,128,100,100,100,100,100,100,100,100,100,100,100,100,100,100,100
100,100,100,100,100,100,100,100,100,100,100,100,100,100,128,128,255,255,255,255,255,255,255,255,255,0,255,255,255,255,255,255,0,0,255,255,255,255,255,255,255,255,255,255,255,255,0,0,255,255,255,255,255,255,0,255,255,255,255,255,255,255,255,255,128,128,100,100,100,100,100,100,100,100,100,100,100,100,100,100
100,100,100,100,100,100,100,100,100,100,100,100,100,100,128,128,255,255,255,255,255,255,255,255,0,255,255,255,255,255,255,255,255,255,255,255,255,255,255,255,255,255,255,255,255,255,255,255,255,255,255,255,255,255,255,0,255,255,255,255,255,255,255,255,128,128,100,100,100,100,100,100,100,100,100,100,100,100,100,100
100,100,100,100,100,100,100,100,100,100,100,100,100,128,128,255,255,255,255,255,255,255,255,0,255,255,255,255,0,255,255,255,255,255,255,255,0,0,0,0,0,0,0,0,255,255,255,255,255,255,255,0,255,255,255,255,0,255,255,255,255,255,255,255,255,128,128,100,100,100,100,100,100,100,100,100,100,100,100,100
100,100,100,100,100,100,100,100,100,100,100,100,100,128,128,255,255,255,255,255,255,255,0,255,255,255,255,255,0,255,255,255,255,0,0,0,255,255,255,255,255,255,255,255,0,0,0,255,255,255,255,0,255,255,255,255,255,0,255,255,255,255,255,255,255,128,128,100,100,100,100,100,100,100,100,100,100,100,100,100
100,100,100,100,100,100,100,100,100,100,100,100,128,128,255,255,255,255,255,255,255,255,0,255,255,0,0,0,0,255,255,255,0,255,255,255,255,255,255,255,255,255,255,255,255,255,255,0,255,255,255,0,0,0,0,255,255,0,255,255,255,255,255,255,255,255,128,128,100,100,100,100,100,100,100,100,100,100,100,100
100,100,100,100,100,100,100,100,100,100,100,100,128,128,255,255,255,0,0,255,255,0,255,255,255,255,255,255,255,255,255,0,255,255,255,255,255,255,255,255,255,255,255,255,255,255,255,255,0,255,255,255,255,255,255,255,255,255,0,255,255,255,255,255,255,255,128,128,100,100,100,100,100,100,100,100,100,100,100,100
100,100,100,100,100,100,100,100,100,100,100,100,128,128,255,255,255,0,0,255,0,255,255,255,255,255,255,255,255,255,255,255,255,255,255,255,255,255,255,255,255,255,255,255,255,255,255,255,255,255,255,255,255,255,255,255,255,255,255,0,255,255,0,0,255,255,128,128,100,100,100,100,100,100,100,100,100,100,100,100
100,100,100,100,100,100,100,100,100,100,100,128,128,255,255,255,255,255,255,255,0,255,255,255,255,0,255,255,255,0,255,255,255,255,255,255,255,255,255,255,255,255,255,255,255,255,255,255,255,255,0,255,255,255,0,255,255,255,255,0,255,255,0,0,255,255,255,128,128,100,100,100,100,100,100,100,100,100,100,100
100,100,100,100,100,100,100,100,100,100,100,128,128,255,255,255,255,255,255,0,255,255,255,255,0,255,255,255,0,255,255,255,255,255,255,255,255,255,0,0,0,0,255,255,255,255,255,255,255,255,255,0,255,255,255,0,255,255,255,255,0,255,255,255,255,255,255,128,128,100,100,100,100,100,100,100,100,100,100,100
100,100,100,100,100,100,100,100,100,100,100,128,128,255,255,255,255,255,255,0,255,255,255,0,255,255,255,0,255,255,255,255,255,255,255,0,255,255,255,255,255,255,255,255,0,255,255,255,255,255,255,255,0,255,255,255,0,255,255,255,0,255,255,255,255,255,255,128,128,100,100,100,100,100,100,100,100,100,100,100
100,100,100,100,100,100,100,100,100,100,100,128,128,255,255,255,255,255,0,255,255,255,255,0,255,255,255,0,255,255,255,255,255,255,0,255,255,255,255,255,255,255,255,255,255,0,255,255,255,255,255,255,0,255,255,255,0,255,255,255,255,0,255,255,255,255,255,128,128,100,100,100,100,100,100,100,100,100,100,100
100,100,100,100,100,100,100,100,100,100,128,128,255,255,255,255,255,255,0,255,255,255,0,255,255,255,255,0,255,255,255,255,255,0,255,255,255,255,0,0,0,0,255,255,255,255,0,255,255,255,255,255,0,255,255,255,255,0,255,255,255,0,255,255,255,255,255,255,128,128,100,100,100,100,100,100,100,100,100,100
100,100,100,100,100,100,100,100,100,100,128,128,255,255,255,255,255,255,0,255,255,255,0,255,255,255,0,255,255,255,255,255,255,255,255,255,255,255,255,255,255,255,0,255,255,255,255,255,255,255,255,255,255,0,255,255,255,0,255,255,255,0,255,255,255,255,255,255,128,128,100,100,100,100,100,100,100,100,100,100
100,100,100,100,100,100,100,100,100,100,128,128,255,255,255,255,255,255,0,255,255,255,0,255,255,255,0,255,255,255,255,255,255,255,255,255,255,255,255,255,255,255,255,0,255,255,255,255,255,255,255,255,255,0,255,255,255,0,255,255,255,0,255,255,255,255,255,255,128,128,100,100,100,100,100,100,100,100,100,100
100,100,100,100,100,100,100,100,100,100,128,128,255,255,255,255,255,255,0,255,255,255,0,255,255,255,0,255,255,255,255,255,0,255,255,255,255,255,0,0,0,255,255,0,255,255,255,0,255,255,255,255,255,0,255,255,255,0,255,255,255,0,255,255,255,255,255,255,128,128,100,100,100,100,100,100,100,100,100,100
100,100,100,100,100,100,100,100,100,100,128,128,255,255,0,0,255,255,255,255,255,255,0,255,255,255,0,255,255,255,255,255,0,255,255,255,255,0,255,255,255,255,255,0,255,255,255,0,255,255,255,255,255,0,255,255,255,0,255,255,255,255,255,255,0,0,255,255,128,128,100,100,100,100,100,100,100,100,100,100
100,100,100,100,100,100,100,100,100,100,128,128,255,255,0,0,255,255,255,255,255,255,0,255,255,255,0,255,255,255,255,255,0,255,255,255,0,255,255,255,255,255,0,255,255,255,255,0,255,255,255,255,255,0,255,255,255,0,255,255,255,255,255,255,0,0,255,255,128,128,100,100,100,100,100,100,100,100,100,100
100,100,100,100,100,100,100,100,100,100,128,128,255,255,255,255,255,255,0,255,255,255,0,255,255,255,0,255,255,255,255,255,0,255,255,255,0,255,255,0,0,0,255,255,255,255,255,0,255,255,255,255,255,0,255,255,255,0,255,255,255,0,255,255,255,255,255,255,128,128,100,100,100,100,100,100,100,100,100,100
100,100,100,100,100,100,100,100,100,100,128,128,255,255,255,255,255,255,0,255,255,255,0,255,255,255,0,255,255,255,255,255,255,255,255,255,0,255,255,255,255,255,255,255,255,255,255,255,255,255,255,255,255,0,255,255,255,0,255,255,255,0,255,255,255,255,255,255,128,128,100,100,100,100,100,100,100,100,100,100
100,100,100,100,100,100,100,100,100,100,128,128,255,255,255,255,255,255,0,255,255,255,0,255,255,255,0,255,255,255,255,255,255,255,255,255,255,0,255,255,255,255,255,255,255,255,255,255,255,255,255,255,255,0,255,255,255,0,255,255,255,0,255,255,255,255,255,255,128,128,100,100,100,100,100,100,100,100,100,100
100,100,100,100,100,100,100,100,100,100,128,128,255,255,255,255,255,255,0,255,255,255,0,255,255,255,255,0,255,255,255,255,255,0,255,255,255,255,0,0,0,0,255,255,255,255,0,255,255,255,255,255,0,255,255,255,255,0,255,255,255,0,255,255,255,255,255,255,128,128,100,100,100,100,100,100,100,100,100,100
100,100,100,100,100,100,100,100,100,100,100,128,128,255,255,255,255,255,0,255,255,255,255,0,255,255,255,0,255,255,255,255,255,255,0,255,255,255,255,255,255,255,255,255,255,0,255,255,255,255,255,255,0,255,255,255,0,255,255,255,255,0,255,255,255,255,255,128,128,100,100,100,100,100,100,100,100,100,100,100
100,100,100,100,100,100,100,100,100,100,100,128,128,255,255,255,255,255,255,0,255,255,255,0,255,255,255,0,255,255,255,255,255,255,255,0,255,255,255,255,255,255,255,255,0,255,255,255,255,255,255,255,0,255,255,255,0,255,255,255,0,255,255,255,255,255,255,128,128,100,100,100,100,100,100,100,100,100,100,100
100,100,100,100,100,100,100,100,100,100,100,128,128,255,255,255,255,255,255,0,255,255,255,255,0,255,255,255,0,255,255,255,255,255,255,255,255,255,0,0,0,0,255,255,255,255,255,255,255,255,255,0,255,255,255,0,255,255,255,255,0,255,255,255,255,255,255,128,128,100,100,100,100,100,100,100,100,100,100,100
100,100,100,100,100,100,100,100,100,100,100,128,128,255,255,255,255,255,255,255,0,255,255,255,255,0,255,255,255,0,255,255,255,255,255,255,255,255,255,255,255,255,255,255,255,255,255,255,255,255,0,255,255,255,0,255,255,255,255,0,255,255,255,255,255,255,255,128,128,100,100,100,100,100,100,100,100,100,100,100
100,100,100,100,100,100,100,100,100,100,100,100,128,128,255,255,255,0,0,255,0,255,255,255,255,255,255,255,255,255,255,255,255,255,255,255,255,255,255,255,255,255,255,255,255,255,255,255,255,255,255,255,255,255,255,255,255,255,255,0,255,0,0,255,255,255,128,128,100,100,100,100,100,100,100,100,100,100,100,100
100,100,100,100,100,100,100,100,100,100,100,100,128,128,255,255,255,0,0,255,255,0,255,255,255,255,255,255,255,255,255,0,255,255,255,255,255,255,255,255,255,255,255,255,255,255,255,255,0,255,255,255,255,255,255,255,255,255,0,255,255,0,0,255,255,255,128,128,100,100,100,100,100,100,100,100,100,100,100,100
100,100,100,100,100,100,100,100,100,100,100,100,128,128,255,255,255,255,255,255,255,255,0,255,255,0,0,0,0,255,255,255,0,255,255,255,255,255,255,255,255,255,255,255,255,255,255,0,255,255,255,0,0,0,0,255,255,0,255,255,255,255,255,255,255,255,128,128,100,100,100,100,100,100,100,100,100,100,100,100
100,100,100,100,100,100,100,100,100,100,100,100,100,128,128,255,255,255,255,255,255,255,0,255,255,255,255,255,0,255,255,255,255,0,0,0,255,255,255,255,255,255,255,255,0,0,0,255,255,255,255,0,255,255,255,255,255,0,255,255,255,255,255,255,255,128,128,100,100,100,100,100,100,100,100,100,100,100,100,100
100,100,100,100,100,100,100,100,100,100,100,100,100,128,128,255,255,255,255,255,255,255,255,0,255,255,255,255,0,255,255,255,255,255,255,255,0,0,0,0,0,0,0,0,255,255,255,255,255,255,255,0,255,255,255,255,0,255,255,255,255,255,255,255,255,128,128,100,100,100,100,100,100,100,100,100,100,100,100,100
100,100,100,100,100,100,100,100,100,100,100,100,100,100,128,128,255,255,255,255,255,255,255,255,0,255,255,255,255,255,255,255,255,255,255,255,255,255,255,255,255,255,255,255,255,255,255,255,255,255,255,255,255,255,255,0,255,255,255,255,255,255,255,255,128,128,100,100,100,100,100,100,100,100,100,100,100,100,100,100
100,100,100,100,100,100,100,100,100,100,100,100,100,100,128,128,255,255,255,255,255,255,255,255,255,0,255,255,255,255,255,255,0,0,255,255,255,255,255,255,255,255,255,255,255,255,0,0,255,255,255,255,255,255,0,255,255,255,255,255,255,255,255,255,128,128,100,100,100,100,100,100,100,100,100,100,100,100,100,100
100,100,100,100,100,100,100,100,100,100,100,100,100,100,100,128,128,255,255,255,255,255,255,255,255,255,0,0,255,255,255,255,255,255,0,0,0,0,0,0,0,0,0,0,0,0,255,255,255,255,255,255,0,0,255,255,255,255,255,255,255,255,255,128,128,100,100,100,100,100,100,100,100,100,100,100,100,100,100,100
100,100,100,100,100,100,100,100,100,100,100,100,100,100,100,100,128,128,255,255,255,255,0,0,255,255,255,255,0,255,255,255,255,255,255,255,255,255,255,255,255,255,255,255,255,255,255,255,255,255,255,0,255,255,255,255,255,0,0,255,255,255,128,128,100,100,100,100,100,100,100,100,100,100,100,100,100,100,100,100
100,100,100,100,100,100,100,100,100,100,100,100,100,100,100,100,128,128,255,255,255,255,0,0,255,255,255,255,255,0,0,255,255,255,255,255,255,255,255,255,255,255,255,255,255,255,255,255,255,0,0,255,255,255,255,255,255,0,0,255,255,255,128,128,100,100,100,100,100,100,100,100,100,100,100,100,100,100,100,100
100,100,100,100,100,100,100,100,100,100,100,100,100,100,100,100,100,128,128,255,255,255,255,255,255,255,255,255,255,255,255,0,0,255,255,255,255,255,255,255,255,255,255,255,255,255,255,0,0,255,255,255,255,255,255,255,255,255,255,255,255,128,128,100,100,100,100,100,100,100,100,100,100,100,100,100,100,100,100,100
100,100,100,100,100,100,100,100,100,100,100,100,100,100,100,100,100,100,128,128,255,255,255,255,255,255,255,255,255,255,255,255,255,0,0,0,0,0,0,255,255,0,0,0,0,0,0,255,255,255,255,255,255,255,255,255,255,255,255,255,128,128,100,100,100,100,100,100,100,100,100,100,100,100,100,100,100,100,100,100
100,100,100,100,100,100,100,100,100,100,100,100,100,100,100,100,100,100,100,128,128,255,255,255,255,255,255,255,255,0,0,255,255,255,255,255,255,255,255,255,255,255,255,255,255,255,255,255,255,0,0,255,255,255,255,255,255,255,255,128,128,100,100,100,100,100,100,100,100,100,100,100,100,100,100,100,100,100,100,100
100,100,100,100,100,100,100,100,100,100,100,100,100,100,100,100,100,100,100,100,128,128,128,255,255,255,255,255,255,0,0,255,255,255,255,255,255,255,255,255,255,255,255,255,255,255,255,255,255,0,0,255,255,255,255,255,255,128,128,128,100,100,100,100,100,100,100,100,100,100,100,100,100,100,100,100,100,100,100,100
100,100,100,100,100,100,100,100,100,100,100,100,100,100,100,100,100,100,100,100,100,128,128,128,255,255,255,255,255,255,255,255,255,255,255,255,255,255,255,0,0,255,255,255,255,255,255,255,255,255,255,255,255,255,255,255,128,128,128,100,100,100,100,100,100,100,100,100,100,100,100,100,100,100,100,100,100,100,100,100
100,100,100,100,100,100,100,100,100,100,100,100,100,100,100,100,100,100,100,100,100,100,100,128,128,128,255,255,255,255,255,255,255,255,255,255,255,255,255,0,0,255,255,255,255,255,255,255,255,255,255,255,255,255,128,128,128,100,100,100,100,100,100,100,100,100,100,100,100,100,100,100,100,100,100,100,100,100,100,100
100,100,100,100,100,100,100,100,100,100,100,100,100,100,100,100,100,100,100,100,100,100,100,100,128,128,128,128,255,255,255,255,255,255,255,255,255,255,255,255,255,255,255,255,255,255,255,255,255,255,255,255,128,128,128,128,100,100,100,100,100,100,100,100,100,100,100,100,100,100,100,100,100,100,100,100,100,100,100,100
100,100,100,100,100,100,100,100,100,100,100,100,100,100,100,100,100,100,100,100,100,100,100,100,100,100,128,128,128,128,128,255,255,255,255,255,255,255,255,255,255,255,255,255,255,255,255,255,255,128,128,128,128,128,100,100,100,100,100,100,100,100,100,100,100,100,100,100,100,100,100,100,100,100,100,100,100,100,100,100
100,100,100,100,100,100,100,100,100,100,100,100,100,100,100,100,100,100,100,100,100,100,100,100,100,100,100,100,128,128,128,128,128,128,128,255,255,255,255,255,255,255,255,255,255,128,128,128,128,128,128,128,100,100,100,100,100,100,100,100,100,100,100,100,100,100,100,100,100,100,100,100,100,100,100,100,100,100,100,100
100,100,100,100,100,100,100,100,100,100,100,100,100,100,100,100,100,100,100,100,100,100,100,100,100,100,100,100,100,100,100,128,128,128,128,128,128,128,128,128,128,128,128,128,128,128,128,128,128,100,100,100,100,100,100,100,100,100,100,100,100,100,100,100,100,100,100,100,100,100,100,100,100,100,100,100,100,100,100,100
100,100,100,100,100,100,100,100,100,100,100,100,100,100,100,100,100,100,100,100,100,100,100,100,100,100,100,100,100,100,100,100,100,100,100,128,128,128,128,128,128,128,128,128,128,100,100,100,100,100,100,100,100,100,100,100,100,100,100,100,100,100,100,100,100,100,100,100,100,100,100,100,100,100,100,100,100,100,100,100
